####################
#..................#
#..................#
#..................#
#..................#
#..................#
#..................#
#..................#
#..................#
#..................#
#..................#
#..................#
#..................#
#....P.............#
#..#####......@...2#
#............#######
#.............I.@..#
#....@@...##########
#..1.....S.....@...#
####################