....................
....................
....................
....................
....................
....................
....................
....................
..1.................
....................
....................
....................
....................
....................
....................
....................
....................
.........####.......
....................
####################