####################
#..................#
#..................#
#..................#
#..................#
#..................#
#..................#
#..................#
#..................#
#..................#
#..................#
#..................#
#..................#
#..................#
#..#####..........2#
#............#######
#..................#
#.........##########
#..1.....A.........#
####################