####################
#..................#
#..................#
#..................#
#..................#
#..................#
#..................#
#..................#
#..................#
#..................#
#..................#
#..................#
#..................#
#.................2#
#..#####...........#
#............#######
#...............A..#
#....##...##########
#..1.....A.........#
####################