....................
....................
....................
....................
....................
....................
....................
....................
....................
....................
....................
....................
....................
....................
................##..
......1.............
......##............
..........###.......
....................
####################