####################
#..................#
#..................#
#..................#
#..................#
#..................#
#..................#
#..................#
#..................#
#..................#
#..................#
#..................#
#..................#
#...####.....#.....#
#.............######
#..................#
#.........#.....S..#
#...##....##########
#..1.....A.........#
####################