....................
....................
....................
....................
....................
....................
....................
....................
....................
....................
....................
....................
....................
....................
....................
........@...........
......@...@.........
..1.........@.......
..............@..2..
####################